+++++++++++++++++++++++++++++++++++++++++
+FLKK                                   +
+++++     + ++++++++++++++++++++++++++  +
+         + +                       0+  +
+         + + ++++++++++++++++++++++++  +
+         +NO                        +  +
+         ++++++++++++++++++++++++++ +  +
+           +                        +  +
+           + ++++++++++++++++++++++++  +
+           +                        +  +
+           ++++++++++++++++++++++++ +  +
+                                    +  +
+           ++++++++++++++++++++++++++  +
+                                       +
+ + +                                   +
+++a+++++++++++K+++++++H++++K++++++++++++
  +b+         +B+     +A+  +D+
  +c+         +G+     +E+  +C+
  +d+         +J+     +I+  +++
  +e+         +m+     +++
  +f+         +++
  +g+
  +h++++
  +ik  +
  +jl+M+
  ++++++
