+++++++++++++++++++++++++++++++++++++++++
+FK                                     +
+KK                                     +
+                                       +
+                                       +
+                              0        +
+                                       +
+                                       +
+                                       +
+                                       +
+                                       +
+                                       +
+                                       +
+                                       +
+  K                                    +
+++a+++++++++++K+++++++H++++K++++++++++++
  +b+         +B+     +A+  +D+
  +c+         +G+     +E+  +C+
  +d+         +J+     +I+  +++
  +e+         +++     +++
  +f+
  +g+
  +h+
  +i+
  +j+
  +++
