+++++++++++++++++++++++
+  0                  +    
+B+ +i+               +
+D+ +h+               +
+F+ +g+     Jj        +
+H+ +f+               +
+I+ +e+               +
+G+ +d+               +
+E+ +c+               +
+C+ +b+               +
+A+ +a+               +
+++++++++++++++++++++++
