+++++++++++++++++++
+                 +
+                 +
+                 +
+                 +
+                 +
+ aAAa            +
+  0Aa            +
+                 +
+++++++++++++++++++