++++++++++++
+0         +
+          +
+          +
+          +
+          +
+          +
+          +
+          +
+          +
+          +
+          +
++++++++++++