+++++++++++++++++++
+0              +b+
+              ++++
+                 +
+              ++A+
+               +a+
+++++++++++++++++++
