++++++++++++
+0        a+
+          +
+          +
+          +
+          +
+          +
+          +
+          +
+          +
+          +
+          +
++++++++++++
